02,02,02,02,02,02,02,02,02,02,02,02,02,02,02,02,02,02,02,02,02,02,02,02,02,02,02,02,02,02,02,01,01,01,01,01,01,02,02,02,02,02,02,01,00,20,15,10,05,00
02,01,01,01,01,01,01,01,02,02,02,02,02,02,01,01,01,01,01,01,01,01,02,02,02,02,02,02,02,02,01,01,19,00,00,19,01,01,02,02,02,02,02,01,00,21,16,11,07,01
02,01,05,00,15,00,05,01,02,02,02,02,02,01,01,10,00,15,00,00,10,01,01,02,02,02,02,02,02,01,01,19,20,00,00,20,19,01,01,02,02,02,02,01,00,01,17,12,08,02
02,01,00,00,00,00,00,01,01,01,01,01,01,01,11,00,00,00,00,00,00,00,01,02,02,02,02,02,02,01,11,00,00,00,00,00,00,12,01,02,02,02,02,06,00,22,18,13,06,03
02,01,00,00,00,00,00,22,00,00,15,00,21,06,00,00,00,00,00,00,00,00,01,02,02,02,02,02,02,01,11,00,00,00,00,00,00,12,01,02,02,02,02,09,00,23,19,14,09,04
02,01,00,00,00,00,00,23,21,00,00,00,00,09,00,00,00,00,00,00,00,00,01,02,02,02,02,02,02,01,01,20,00,00,00,00,20,01,01,02,02,02,02,01,00,00,00,00,00,00
02,01,00,00,00,00,00,01,01,01,01,01,01,01,11,00,00,00,00,00,00,00,01,02,02,02,02,02,02,02,01,01,21,00,00,00,01,01,02,02,02,02,02,01,01,01,01,01,01,01
02,01,05,00,15,00,05,01,02,02,02,02,02,01,01,10,00,00,00,15,10,01,01,02,02,02,02,02,02,02,02,01,01,07,08,01,01,02,02,02,02,02,02,02,02,02,02,02,02,02
02,01,01,01,01,01,01,01,02,02,02,02,02,02,01,01,01,07,08,01,01,01,02,02,02,02,02,02,02,02,02,02,01,07,08,01,02,02,02,02,02,02,02,02,02,02,02,02,02,02
02,02,02,02,02,02,02,02,02,02,02,02,02,02,02,02,01,00,21,01,02,02,02,02,02,02,02,02,02,02,02,02,01,15,08,01,02,02,02,02,02,02,02,02,02,02,02,02,02,02
02,02,02,02,02,02,02,02,02,02,02,02,02,02,02,02,01,15,00,01,02,02,02,02,02,02,02,02,02,02,02,02,01,07,08,01,02,02,02,02,02,02,02,02,02,02,02,02,02,02
02,02,02,02,02,02,02,02,02,02,02,02,02,02,02,02,01,21,00,01,02,02,02,02,02,02,02,01,01,01,01,01,01,07,08,01,01,01,01,01,01,01,01,01,01,01,01,01,02,02
02,02,01,01,01,01,01,01,01,01,01,01,01,01,01,01,01,07,08,01,01,01,01,01,01,01,01,01,21,00,00,00,15,00,00,21,00,00,00,15,00,00,00,00,00,00,21,01,01,02
02,01,01,21,00,00,15,00,00,00,21,00,00,00,00,00,15,00,00,00,21,00,15,06,00,00,00,21,00,00,00,00,00,00,00,00,00,00,00,00,00,00,00,00,00,00,21,21,01,02
02,01,21,21,00,00,00,00,21,00,00,15,00,00,21,00,00,00,00,00,00,00,00,09,00,00,00,00,00,15,01,01,01,00,00,01,01,01,01,01,01,01,01,01,01,15,00,00,01,02
02,01,00,00,15,01,01,01,01,01,01,01,01,01,01,01,01,01,01,01,01,00,00,01,01,01,01,01,01,01,01,02,01,00,00,01,02,02,02,02,02,02,02,02,01,01,00,00,01,02
02,01,00,00,01,01,02,02,02,02,02,02,02,02,02,02,02,02,02,02,01,00,00,01,02,02,02,02,02,02,02,01,01,00,15,01,02,02,02,02,02,02,02,02,02,01,00,00,01,02
02,01,00,00,01,02,02,02,02,02,02,02,02,02,02,02,02,02,02,02,01,15,00,01,02,02,02,02,02,02,01,01,21,00,00,01,02,02,02,02,02,02,02,02,02,01,00,00,01,02
02,01,15,00,01,01,01,01,01,01,01,01,01,01,01,01,01,01,01,01,01,00,00,01,01,01,01,01,01,01,01,00,00,00,00,01,02,02,02,02,02,02,02,02,01,01,00,15,01,02
02,01,00,00,00,00,15,00,00,21,00,00,00,00,00,15,00,00,21,00,00,00,00,00,00,00,21,15,00,00,00,00,00,00,01,01,02,02,02,02,02,02,02,01,01,21,00,00,01,02
02,01,21,00,00,00,21,00,00,00,00,15,00,00,00,00,00,00,00,00,15,00,00,21,00,00,00,00,00,00,21,00,15,01,01,02,02,02,02,02,02,02,02,01,21,00,00,00,01,02
02,01,00,00,01,01,01,01,01,01,01,01,01,01,01,01,01,01,01,01,01,07,08,01,01,01,01,01,01,01,01,01,01,01,02,02,02,02,02,02,02,02,02,01,15,00,00,01,01,02
02,01,00,15,01,02,02,02,02,02,02,02,02,02,02,02,02,02,02,02,01,07,08,01,02,02,02,02,02,02,02,02,02,02,02,02,02,02,02,02,02,02,02,01,00,00,01,01,02,02
02,01,07,08,01,02,02,02,02,02,02,02,02,02,02,02,02,02,02,02,01,07,08,01,02,02,02,02,02,02,02,02,02,02,02,02,02,02,02,02,02,02,02,01,00,00,01,02,02,02
02,01,07,08,01,02,02,02,02,02,02,02,02,02,02,02,02,02,02,01,01,07,08,01,01,02,02,02,02,02,02,02,02,02,02,02,02,02,02,02,02,02,01,01,00,15,01,02,02,02
02,01,07,08,01,01,01,01,01,02,02,02,02,02,02,02,02,02,01,01,14,03,00,15,01,01,02,02,02,02,02,02,02,02,02,02,02,02,02,02,02,01,01,15,00,00,01,02,02,02
02,01,15,00,00,00,03,15,01,01,02,02,02,02,02,02,02,01,01,14,14,03,00,00,10,01,01,02,02,02,02,02,02,02,02,02,02,02,02,02,01,01,00,00,00,21,01,02,02,02
02,01,03,21,00,00,00,00,21,01,02,02,02,02,02,02,01,01,14,13,14,03,00,00,00,12,01,01,02,02,02,02,02,02,02,02,02,02,02,02,01,16,00,00,21,01,01,02,02,02
02,01,01,01,03,00,00,03,00,01,02,02,02,02,02,02,01,13,14,14,14,03,00,00,00,00,21,01,01,01,01,01,01,01,01,01,01,02,02,02,01,07,00,16,01,01,02,02,02,02
02,02,02,01,01,00,00,00,15,01,01,02,02,02,02,02,01,14,14,03,03,03,00,00,00,00,00,06,06,15,21,06,06,06,21,16,01,01,02,02,01,07,08,01,01,02,02,02,02,02
02,02,01,01,00,03,00,00,03,12,01,01,02,02,02,02,01,14,14,14,03,00,00,00,00,00,00,09,09,09,09,09,09,09,00,00,16,01,01,01,01,07,08,01,02,02,02,02,02,02
02,01,01,11,00,00,00,00,00,03,00,01,01,02,02,02,01,13,14,03,03,00,00,00,00,00,00,01,01,01,01,01,01,01,16,00,00,16,01,01,16,00,00,01,02,02,02,02,02,02
02,01,03,03,00,03,00,00,00,00,03,03,01,02,02,02,01,01,14,03,00,00,00,00,00,10,01,01,02,02,02,02,02,01,01,16,00,00,00,00,00,00,00,01,02,02,02,02,02,02
02,01,04,03,00,00,03,00,00,00,03,04,01,02,02,02,02,01,01,03,00,00,00,00,12,01,01,02,02,02,02,02,02,02,01,01,00,00,00,00,00,00,16,01,02,02,02,02,02,02
02,01,03,03,03,00,00,00,00,00,00,03,01,02,02,02,02,02,01,01,01,07,08,01,01,01,02,02,02,02,02,02,02,02,02,01,16,00,00,00,00,16,01,01,02,02,02,02,02,02
02,01,03,04,03,00,00,00,03,00,00,03,01,02,02,02,02,02,02,02,01,07,15,01,02,02,02,02,02,02,02,02,02,02,02,01,16,00,00,00,00,16,01,02,02,02,02,02,02,02
02,01,03,03,03,00,03,00,00,00,00,15,01,02,02,02,02,02,02,02,01,00,00,01,01,01,01,02,02,02,02,02,02,02,01,01,00,00,00,00,00,00,01,01,02,02,02,02,02,02
02,01,04,03,00,00,00,00,00,00,03,03,01,02,02,02,02,02,02,02,01,00,00,00,00,00,01,02,02,02,02,02,02,01,01,17,00,00,00,00,00,00,17,01,01,02,02,02,02,02
02,01,01,15,00,03,00,00,03,00,12,01,01,02,02,02,02,02,02,02,01,15,21,00,00,00,01,02,02,02,02,02,01,01,17,00,18,00,00,00,00,18,00,17,01,01,02,02,02,02
02,02,01,01,11,00,00,03,00,00,01,01,02,02,02,02,02,02,02,02,01,01,01,01,00,15,01,02,02,02,02,01,01,17,18,00,00,00,00,00,00,00,00,18,17,01,01,02,02,02
02,02,02,01,01,03,00,00,03,01,01,02,02,02,02,02,02,02,02,02,02,02,01,01,00,00,01,02,02,02,02,01,17,14,14,00,18,00,00,00,00,18,00,14,14,17,01,02,02,02
02,02,02,02,01,01,07,08,01,01,02,02,02,02,02,02,02,02,02,02,02,01,01,00,00,00,01,02,02,02,02,01,13,14,18,00,00,00,00,00,00,00,00,18,14,13,01,02,02,02
02,02,02,02,02,01,07,08,01,02,02,02,02,02,02,02,02,02,02,02,01,01,15,00,00,00,01,02,02,02,02,01,13,14,14,00,00,00,00,00,00,00,00,14,14,13,01,02,02,02
02,02,02,02,02,01,15,08,01,02,02,02,02,02,02,02,02,02,02,01,01,00,00,00,21,01,01,02,02,02,02,01,13,14,18,00,18,00,00,00,00,00,00,18,14,13,01,02,02,02
02,02,02,02,02,01,07,08,01,01,01,01,01,01,01,01,01,01,01,01,00,00,00,21,01,01,02,02,02,02,02,01,17,14,14,00,00,00,00,00,18,00,00,14,14,17,01,02,02,02
02,02,02,02,02,01,00,00,00,00,00,21,00,00,15,00,00,00,00,00,00,00,15,01,01,02,02,02,02,02,02,01,01,17,18,00,00,00,00,00,00,00,00,18,17,01,01,02,02,02
02,02,02,02,02,01,21,00,00,15,00,00,00,00,00,21,00,00,15,00,00,00,01,01,02,02,02,02,02,02,02,02,01,01,17,00,18,00,00,00,18,00,00,17,01,01,02,02,02,02
02,02,02,02,02,01,01,01,01,01,01,01,01,01,01,01,01,01,01,01,01,01,01,02,02,02,02,02,02,02,02,02,02,01,01,17,00,00,00,00,00,00,17,01,01,02,02,02,02,02
02,02,02,02,02,02,02,02,02,02,02,02,02,02,02,02,02,02,02,02,02,02,02,02,02,02,02,02,02,02,02,02,02,02,01,01,01,01,01,01,01,01,01,01,02,02,02,02,02,02
02,02,02,02,02,02,02,02,02,02,02,02,02,02,02,02,02,02,02,02,02,02,02,02,02,02,02,02,02,02,02,02,02,02,02,02,02,02,02,02,02,02,02,02,02,02,02,02,02,02

0,0,0,0,0,0,0,0,0,0,0,0,0,0,0,0,0,0,0,0,0,0,0,0,0,0,0,0,0,0,0,0,1,1,1,1,0,0,0,0,0,0,0,1,0,0,0,0,0,0
0,0,1,1,1,1,1,0,0,0,0,0,0,0,0,1,1,1,1,1,1,0,0,0,0,0,0,0,0,0,0,1,0,0,0,0,1,0,0,0,0,0,0,1,0,0,0,0,0,0
0,1,0,0,0,0,0,1,0,0,0,0,0,0,1,0,0,0,0,0,0,1,0,0,0,0,0,0,0,0,1,0,0,0,0,0,0,1,1,1,1,1,1,1,0,0,0,0,0,0
0,1,0,0,0,0,0,1,1,1,1,1,1,1,0,0,0,0,0,0,0,0,1,0,0,0,0,0,0,1,0,0,0,0,0,0,0,0,0,0,0,0,0,0,0,0,0,0,0,0
0,1,0,0,0,0,0,0,0,0,0,0,0,0,0,0,0,0,0,0,0,0,1,0,0,0,0,0,0,1,0,0,0,0,0,0,0,0,0,0,0,0,0,0,0,0,0,0,0,0
0,1,0,0,0,0,0,0,0,0,0,0,0,0,0,0,0,0,0,0,0,0,1,0,0,0,0,0,0,0,1,0,0,0,0,0,0,1,1,1,1,1,1,1,0,0,0,0,0,0
0,1,0,0,0,0,0,1,1,1,1,1,1,1,0,0,0,0,0,0,0,0,1,0,0,0,0,0,0,0,0,1,0,0,0,0,1,0,0,0,0,0,0,0,1,1,1,1,1,1
0,1,0,0,0,0,0,1,0,0,0,0,0,0,1,0,0,0,0,0,0,1,1,0,0,0,0,0,0,0,0,0,1,0,0,1,0,0,0,0,0,0,0,0,0,0,0,0,0,0
0,0,1,1,1,1,1,0,0,0,0,0,0,0,0,1,1,0,0,1,1,0,0,0,0,0,0,0,0,0,0,0,1,0,0,1,0,0,0,0,0,0,0,0,0,0,0,0,0,0
0,0,0,0,0,0,0,0,0,0,0,0,0,0,0,0,1,0,0,1,0,0,0,0,0,0,0,0,0,0,0,0,1,0,0,1,0,0,0,0,0,0,0,0,0,0,0,0,0,0
0,0,0,0,0,0,0,0,0,0,0,0,0,0,0,0,1,0,0,1,0,0,0,0,0,0,0,0,0,0,0,0,1,0,0,1,0,0,0,0,0,0,0,0,0,0,0,0,0,0
0,0,0,0,0,0,0,0,0,0,0,0,0,0,0,0,1,0,0,1,0,0,0,0,0,0,0,1,1,1,1,1,1,0,0,1,1,1,1,1,1,1,1,1,1,1,1,1,0,0
0,0,0,1,1,1,1,1,1,1,1,1,1,1,1,1,1,0,0,1,1,1,1,1,1,1,1,1,0,0,0,0,0,0,0,0,0,0,0,0,0,0,0,0,0,0,0,1,0,0
0,0,1,0,0,0,0,0,0,0,0,0,0,0,0,0,0,0,0,0,0,0,0,0,0,0,0,0,0,0,0,0,0,0,0,0,0,0,0,0,0,0,0,0,0,0,0,0,1,0
0,1,0,0,0,0,0,0,0,0,0,0,0,0,0,0,0,0,0,0,0,0,0,0,0,0,0,0,0,0,1,1,1,0,0,1,1,1,1,1,1,1,1,1,1,0,0,0,1,0
0,1,0,0,0,1,1,1,1,1,1,1,1,1,1,1,1,1,1,1,1,0,0,1,1,1,1,1,1,1,0,0,1,0,0,1,0,0,0,0,0,0,0,0,0,1,0,0,1,0
0,1,0,0,1,0,0,0,0,0,0,0,0,0,0,0,0,0,0,0,1,0,0,1,0,0,0,0,0,0,0,0,1,0,0,1,0,0,0,0,0,0,0,0,0,1,0,0,1,0
0,1,0,0,1,0,0,0,0,0,0,0,0,0,0,0,0,0,0,0,1,0,0,1,0,0,0,0,0,0,0,1,0,0,0,1,0,0,0,0,0,0,0,0,0,1,0,0,1,0
0,1,0,0,1,1,1,1,1,1,1,1,1,1,1,1,1,1,1,1,1,0,0,1,1,1,1,1,1,1,1,0,0,0,0,1,0,0,0,0,0,0,0,0,0,1,0,0,1,0
0,1,0,0,0,0,0,0,0,0,0,0,0,0,0,0,0,0,0,0,0,0,0,0,0,0,0,0,0,0,0,0,0,0,1,0,0,0,0,0,0,0,0,0,1,0,0,0,1,0
0,1,0,0,0,0,0,0,0,0,0,0,0,0,0,0,0,0,0,0,0,0,0,0,0,0,0,0,0,0,0,0,0,1,0,0,0,0,0,0,0,0,0,1,0,0,0,0,1,0
0,1,0,0,1,1,1,1,1,1,1,1,1,1,1,1,1,1,1,1,1,0,0,1,1,1,1,1,1,1,1,1,1,0,0,0,0,0,0,0,0,0,0,1,0,0,0,1,0,0
0,1,0,0,1,0,0,0,0,0,0,0,0,0,0,0,0,0,0,0,1,0,0,1,0,0,0,0,0,0,0,0,0,0,0,0,0,0,0,0,0,0,0,1,0,0,1,0,0,0
0,1,0,0,1,0,0,0,0,0,0,0,0,0,0,0,0,0,0,0,1,0,0,1,0,0,0,0,0,0,0,0,0,0,0,0,0,0,0,0,0,0,0,1,0,0,1,0,0,0
0,1,0,0,1,0,0,0,0,0,0,0,0,0,0,0,0,0,0,1,1,0,0,1,0,0,0,0,0,0,0,0,0,0,0,0,0,0,0,0,0,0,0,1,0,0,1,0,0,0
0,1,0,0,1,1,1,1,0,0,0,0,0,0,0,0,0,0,0,1,0,0,0,0,1,0,0,0,0,0,0,0,0,0,0,0,0,0,0,0,0,0,1,0,0,0,1,0,0,0
0,1,0,0,0,0,0,0,1,0,0,0,0,0,0,0,0,0,1,0,0,0,0,0,0,1,0,0,0,0,0,0,0,0,0,0,0,0,0,0,0,1,0,0,0,0,1,0,0,0
0,1,0,0,0,0,0,0,0,1,0,0,0,0,0,0,0,1,0,0,0,0,0,0,0,0,1,0,0,0,0,0,0,0,0,0,0,0,0,0,1,0,0,0,0,1,0,0,0,0
0,0,1,1,0,0,0,0,0,1,0,0,0,0,0,0,1,0,0,0,0,0,0,0,0,0,0,1,1,1,1,1,1,1,1,1,0,0,0,0,1,0,0,0,1,0,0,0,0,0
0,0,0,0,1,0,0,0,0,1,0,0,0,0,0,0,1,0,0,0,0,0,0,0,0,0,0,0,0,0,0,0,0,0,0,0,1,0,0,0,1,0,0,1,0,0,0,0,0,0
0,0,0,1,0,0,0,0,0,0,1,0,0,0,0,0,1,0,0,0,0,0,0,0,0,0,0,0,0,0,0,0,0,0,0,0,0,1,0,0,1,0,0,1,0,0,0,0,0,0
0,0,1,0,0,0,0,0,0,0,0,1,0,0,0,0,1,0,0,0,0,0,0,0,0,0,0,1,1,1,1,1,1,1,0,0,0,0,1,1,0,0,0,1,0,0,0,0,0,0
0,1,0,0,0,0,0,0,0,0,0,0,1,0,0,0,0,1,0,0,0,0,0,0,0,0,1,0,0,0,0,0,0,0,1,0,0,0,0,0,0,0,0,1,0,0,0,0,0,0
0,1,0,0,0,0,0,0,0,0,0,0,1,0,0,0,0,0,1,0,0,0,0,0,0,1,0,0,0,0,0,0,0,0,0,1,0,0,0,0,0,0,0,1,0,0,0,0,0,0
0,1,0,0,0,0,0,0,0,0,0,0,1,0,0,0,0,0,0,1,1,0,0,1,1,0,0,0,0,0,0,0,0,0,0,1,0,0,0,0,0,0,1,0,0,0,0,0,0,0
0,1,0,0,0,0,0,0,0,0,0,0,1,0,0,0,0,0,0,0,1,0,0,1,0,0,0,0,0,0,0,0,0,0,0,1,0,0,0,0,0,0,1,0,0,0,0,0,0,0
0,1,0,0,0,0,0,0,0,0,0,0,1,0,0,0,0,0,0,0,1,0,0,1,1,1,0,0,0,0,0,0,0,0,0,1,0,0,0,0,0,0,1,0,0,0,0,0,0,0
0,1,0,0,0,0,0,0,0,0,0,0,1,0,0,0,0,0,0,0,1,0,0,0,0,0,1,0,0,0,0,0,0,0,1,0,0,0,0,0,0,0,0,1,0,0,0,0,0,0
0,0,1,0,0,0,0,0,0,0,0,1,0,0,0,0,0,0,0,0,1,0,0,0,0,0,1,0,0,0,0,0,0,1,0,0,0,0,0,0,0,0,0,0,1,0,0,0,0,0
0,0,0,1,0,0,0,0,0,0,1,0,0,0,0,0,0,0,0,0,1,1,1,1,0,0,1,0,0,0,0,0,1,0,0,0,0,0,0,0,0,0,0,0,0,1,0,0,0,0
0,0,0,0,1,0,0,0,0,1,0,0,0,0,0,0,0,0,0,0,0,0,0,1,0,0,1,0,0,0,0,1,0,0,0,0,0,0,0,0,0,0,0,0,0,0,1,0,0,0
0,0,0,0,0,1,0,0,1,0,0,0,0,0,0,0,0,0,0,0,0,0,1,0,0,0,1,0,0,0,0,1,0,0,0,0,0,0,0,0,0,0,0,0,0,0,1,0,0,0
0,0,0,0,0,1,0,0,1,0,0,0,0,0,0,0,0,0,0,0,0,1,0,0,0,0,1,0,0,0,0,1,0,0,0,0,0,0,0,0,0,0,0,0,0,0,1,0,0,0
0,0,0,0,0,1,0,0,1,0,0,0,0,0,0,0,0,0,0,0,1,0,0,0,0,1,0,0,0,0,0,1,0,0,0,0,0,0,0,0,0,0,0,0,0,0,1,0,0,0
0,0,0,0,0,1,0,0,1,1,1,1,1,1,1,1,1,1,1,1,0,0,0,0,1,0,0,0,0,0,0,1,0,0,0,0,0,0,0,0,0,0,0,0,0,0,1,0,0,0
0,0,0,0,0,1,0,0,0,0,0,0,0,0,0,0,0,0,0,0,0,0,0,1,0,0,0,0,0,0,0,0,1,0,0,0,0,0,0,0,0,0,0,0,0,1,0,0,0,0
0,0,0,0,0,1,0,0,0,0,0,0,0,0,0,0,0,0,0,0,0,0,1,0,0,0,0,0,0,0,0,0,0,1,0,0,0,0,0,0,0,0,0,0,1,0,0,0,0,0
0,0,0,0,0,0,1,1,1,1,1,1,1,1,1,1,1,1,1,1,1,1,0,0,0,0,0,0,0,0,0,0,0,0,1,0,0,0,0,0,0,0,0,1,0,0,0,0,0,0
0,0,0,0,0,0,0,0,0,0,0,0,0,0,0,0,0,0,0,0,0,0,0,0,0,0,0,0,0,0,0,0,0,0,0,1,1,1,1,1,1,1,1,0,0,0,0,0,0,0
0,0,0,0,0,0,0,0,0,0,0,0,0,0,0,0,0,0,0,0,0,0,0,0,0,0,0,0,0,0,0,0,0,0,0,0,0,0,0,0,0,0,0,0,0,0,0,0,0,0

