05,05,05,05,05,05,05,05,05,05,05,05,05,05,05,05,05,05,05,05,05,05,05,05,05,05,05,05,05,05,05,05,05,05,05,05,05,05,04,04,04,04,04,04,04,04,04,04,05,05
05,04,04,04,04,04,04,04,05,05,05,05,05,05,05,05,05,05,05,05,05,05,05,05,05,05,05,05,05,05,05,05,05,05,05,05,05,05,04,02,02,02,02,01,01,01,01,04,04,05
05,04,00,00,00,00,03,04,05,05,05,05,05,05,05,05,05,05,05,05,05,05,05,05,05,05,05,05,05,05,05,05,05,05,05,05,05,05,04,04,02,02,01,01,01,01,01,01,04,04
05,04,00,00,00,00,00,04,04,04,04,04,04,04,04,04,04,04,05,05,05,05,05,05,05,05,05,05,05,05,05,05,05,05,05,05,05,05,05,04,04,01,01,01,01,00,01,01,01,04
05,04,00,00,00,00,00,00,00,00,00,00,00,00,00,00,00,04,05,05,05,05,05,05,05,05,05,05,05,05,05,05,05,05,05,05,05,05,05,05,04,01,01,01,00,00,00,00,00,04
05,04,00,00,00,00,00,00,00,00,00,00,00,00,00,00,00,04,05,05,05,05,05,05,05,05,05,04,04,04,04,04,04,05,05,05,05,05,05,05,04,01,01,00,00,00,00,00,00,04
05,04,00,00,00,00,00,04,04,04,04,04,04,04,04,00,00,04,05,05,05,05,05,05,05,05,04,04,03,00,00,00,04,04,05,05,05,05,05,05,04,00,00,00,00,00,00,03,03,04
05,04,03,00,00,00,00,04,05,05,05,05,05,05,04,00,00,04,05,05,05,05,05,05,05,04,04,00,00,00,00,00,00,04,04,05,05,05,05,05,04,00,00,00,00,00,00,03,03,04
05,04,04,04,04,04,04,04,05,05,05,05,05,05,04,00,00,04,05,05,05,05,05,05,04,04,00,00,00,00,00,00,00,00,04,04,05,05,05,05,04,04,04,04,04,04,04,04,04,04
05,05,05,05,05,05,05,05,05,05,05,05,05,05,04,00,00,04,05,05,05,05,05,04,04,00,00,00,00,00,00,01,00,00,00,04,04,05,05,05,05,05,05,05,05,05,05,05,05,05
05,05,05,05,05,05,05,05,05,05,05,05,05,05,04,00,00,04,05,05,05,05,04,04,00,00,00,00,00,01,01,01,01,00,00,00,03,04,05,05,05,05,04,04,04,04,04,04,05,05
05,05,05,05,05,05,05,05,05,05,05,05,05,05,04,00,00,04,05,05,05,05,04,00,00,00,00,00,01,01,01,01,01,01,00,00,03,04,05,05,05,04,04,00,00,00,03,04,04,05
05,05,05,04,04,04,04,04,04,04,04,04,04,04,04,00,00,04,05,05,05,05,04,00,00,00,00,01,01,02,02,01,01,01,01,01,04,05,05,05,04,04,01,00,00,00,00,03,04,05
05,05,05,04,00,00,00,00,00,00,00,00,00,00,00,00,00,04,05,05,05,05,04,00,00,04,04,04,02,02,02,02,01,01,01,04,04,05,05,04,04,01,01,01,00,00,00,00,04,05
05,05,05,04,00,00,00,00,00,00,00,00,00,00,00,00,00,04,05,05,05,05,04,00,00,04,05,04,04,02,02,02,01,01,04,04,05,05,05,04,02,01,01,01,00,00,00,00,04,05
05,04,04,04,00,00,04,04,04,04,04,04,04,04,04,04,04,04,05,05,05,05,04,00,00,04,05,05,04,04,04,04,04,04,04,05,05,05,05,04,02,01,01,01,00,00,00,00,04,05
05,04,03,00,00,00,04,05,05,05,05,05,05,05,05,05,05,05,05,05,05,04,04,00,00,04,05,05,05,05,05,05,05,05,05,05,05,05,05,04,04,01,01,01,00,00,00,00,04,05
05,04,00,00,00,00,04,04,04,04,05,05,05,05,05,05,05,05,05,05,04,04,00,00,00,04,05,05,05,05,05,05,05,05,05,05,05,05,05,05,04,04,01,00,00,00,00,00,04,05
05,04,00,00,00,00,01,01,02,04,05,05,05,05,05,05,05,05,05,04,04,00,00,00,04,04,05,05,05,05,05,05,05,05,05,05,05,05,05,05,05,04,04,00,00,00,00,00,04,05
05,04,00,00,00,00,00,01,01,04,04,05,05,05,05,05,05,05,04,04,00,00,00,04,04,05,05,05,05,05,05,05,05,05,05,05,05,05,05,05,05,05,04,04,04,04,00,00,04,05
05,04,00,00,00,00,00,01,01,01,04,04,05,05,05,05,05,04,04,00,00,00,04,04,05,05,05,05,05,05,05,05,05,05,05,05,05,05,05,05,05,05,05,05,05,04,00,00,04,05
05,04,00,00,00,00,00,00,00,01,00,04,04,04,04,04,04,04,00,00,00,04,04,04,04,04,04,04,04,04,04,04,04,04,04,04,04,04,04,04,04,04,04,04,04,04,00,00,04,05
05,04,00,00,00,00,00,00,00,00,00,00,00,00,00,00,00,00,00,00,00,00,00,00,00,00,00,00,00,00,00,00,00,00,00,00,00,00,00,00,00,00,00,00,00,00,00,00,04,05
05,04,03,00,00,00,00,00,00,00,00,00,00,00,00,00,00,00,00,00,00,00,00,00,00,00,00,00,00,00,00,00,00,00,00,00,00,00,00,00,00,00,00,00,00,00,00,00,04,05
05,04,04,04,04,04,04,04,04,04,04,04,04,04,04,04,04,00,00,04,04,04,04,04,04,04,04,04,04,04,04,04,04,04,00,00,04,04,04,04,04,04,04,04,04,04,00,00,04,05
05,05,05,05,05,05,05,05,05,05,05,05,05,05,05,05,04,00,00,04,05,05,05,05,05,05,05,05,05,05,05,05,05,04,00,00,04,05,05,05,05,05,05,05,05,04,00,00,04,05
05,05,05,05,05,05,05,05,05,05,05,05,05,05,05,05,04,00,00,04,05,05,05,05,05,05,05,05,05,05,05,05,05,04,00,00,04,05,05,05,05,05,05,05,05,04,00,00,04,05
05,05,05,05,05,05,05,05,05,05,05,05,05,05,05,05,04,00,00,04,05,05,05,05,05,05,05,05,05,05,05,05,05,04,00,00,04,05,05,05,05,05,05,05,05,04,00,00,04,05
05,05,05,04,04,04,04,04,04,04,04,04,04,04,04,04,04,00,00,04,04,04,04,04,04,04,04,04,04,04,04,04,04,04,00,00,04,04,04,04,04,04,04,04,04,04,00,00,04,05
05,05,04,04,00,00,00,00,00,00,00,00,00,00,00,00,00,00,00,00,00,00,00,00,00,00,00,00,00,00,00,00,00,00,00,00,00,00,00,00,00,00,00,00,00,00,00,00,04,05
05,05,04,00,00,00,00,00,00,00,00,00,00,00,00,00,00,00,00,00,00,00,00,00,00,00,00,00,00,00,00,00,00,00,00,00,00,00,00,00,00,00,00,00,00,00,00,00,04,05
05,05,04,00,00,00,00,00,04,04,04,04,04,04,04,04,04,04,04,04,04,04,04,04,04,04,04,04,04,04,04,04,04,04,04,04,04,04,04,04,04,04,04,04,04,04,00,00,04,05
05,05,04,00,00,00,03,04,04,05,05,05,05,05,05,05,05,05,05,05,05,05,05,05,05,05,05,05,05,05,05,05,05,05,05,05,05,05,05,05,05,05,05,05,05,04,00,00,04,05
05,05,04,00,00,00,04,04,05,05,05,05,05,05,05,05,05,05,05,05,05,05,05,05,05,05,05,05,05,05,05,05,05,05,05,05,05,05,05,05,05,05,05,05,05,04,00,00,04,05
05,05,04,00,00,00,04,05,05,05,05,05,05,05,04,04,04,04,04,04,04,04,04,04,04,04,04,04,04,04,04,04,04,04,04,04,04,04,04,04,04,05,05,05,05,04,00,00,04,05
05,05,04,00,00,00,04,05,05,05,05,05,05,05,04,03,03,00,00,00,00,00,00,00,00,00,00,00,00,00,00,00,00,00,00,00,00,00,00,00,04,05,05,05,05,04,00,00,04,05
05,05,04,00,00,00,04,05,05,05,05,05,05,05,04,03,03,00,00,00,00,00,00,00,00,00,00,00,00,00,00,00,00,00,00,00,00,00,00,00,04,05,05,05,05,04,00,00,04,05
05,05,04,00,00,00,04,05,05,05,05,05,05,05,04,04,04,04,04,04,04,04,04,04,04,04,04,04,04,04,04,04,04,00,00,04,04,04,00,00,04,05,05,05,05,04,00,00,04,05
05,05,04,00,00,00,04,04,05,05,05,05,05,05,05,05,05,05,05,05,05,05,05,05,05,05,05,05,05,05,05,05,04,00,00,04,05,04,00,00,04,05,05,05,05,04,00,00,04,05
05,05,04,00,00,00,01,04,04,05,05,05,05,05,05,05,05,05,05,05,05,05,05,05,05,05,05,05,05,05,05,05,04,00,00,04,05,04,00,00,04,05,05,05,05,04,00,00,04,05
05,05,04,00,00,00,01,01,04,04,05,05,05,05,05,05,05,05,05,05,05,05,05,05,05,05,05,05,05,05,05,05,04,00,00,04,05,04,00,00,04,05,05,05,05,04,00,00,04,05
05,05,04,00,00,00,00,01,02,04,04,04,04,04,04,04,04,04,04,04,04,04,04,04,04,04,04,05,05,05,05,05,04,00,00,04,05,04,00,00,04,05,05,05,05,04,00,00,04,05
05,05,04,00,00,00,00,01,01,01,01,00,00,00,00,00,00,00,00,00,00,00,00,00,00,00,04,05,05,05,05,05,04,00,00,04,05,04,00,00,04,05,05,05,05,04,00,00,04,05
05,05,04,00,00,00,00,00,00,00,00,00,00,00,00,00,00,00,00,00,00,00,00,00,00,00,04,05,05,05,05,05,04,00,00,04,05,04,00,00,04,04,05,05,05,04,00,00,04,05
05,05,04,01,00,00,00,00,00,00,00,00,00,00,00,00,00,00,00,04,04,04,04,04,00,00,04,05,05,05,05,05,04,00,00,04,05,04,00,00,00,04,04,04,04,04,00,00,04,05
05,05,04,01,01,00,00,00,00,00,00,00,00,00,00,00,00,00,04,04,05,05,05,04,00,00,04,04,04,04,04,04,04,00,00,04,05,04,00,00,00,00,00,00,00,00,00,00,04,05
05,05,04,01,01,01,01,00,00,00,00,00,00,00,00,00,00,04,04,05,05,05,05,04,00,00,00,00,00,00,00,00,00,00,00,04,05,04,04,00,00,00,00,00,00,00,00,00,04,05
05,05,04,01,01,01,01,01,00,00,00,00,00,00,00,00,04,04,05,05,05,05,05,04,00,00,00,00,00,00,00,00,00,00,00,04,05,05,04,04,04,04,04,04,04,04,04,04,04,05
05,05,04,02,01,01,01,01,01,01,00,00,00,00,00,04,04,05,05,05,05,05,05,04,04,04,04,04,04,04,04,04,04,04,04,04,05,05,05,05,05,05,05,05,05,05,05,05,05,05
05,05,04,04,04,04,04,04,04,04,04,04,04,04,04,04,05,05,05,05,05,05,05,05,05,05,05,05,05,05,05,05,05,05,05,05,05,05,05,05,05,05,05,05,05,05,05,05,05,05

0,0,0,0,0,0,0,0,0,0,0,0,0,0,0,0,0,0,0,0,0,0,0,0,0,0,0,0,0,0,0,0,0,0,0,0,0,0,1,1,1,1,1,1,1,1,1,1,0,0
0,1,1,1,1,1,1,1,0,0,0,0,0,0,0,0,0,0,0,0,0,0,0,0,0,0,0,0,0,0,0,0,0,0,0,0,0,0,1,0,0,0,0,0,0,0,0,1,1,0
0,1,0,0,0,0,0,1,0,0,0,0,0,0,0,0,0,0,0,0,0,0,0,0,0,0,0,0,0,0,0,0,0,0,0,0,0,0,1,1,0,0,0,0,0,0,0,0,1,1
0,1,0,0,0,0,0,1,1,1,1,1,1,1,1,1,1,1,0,0,0,0,0,0,0,0,0,0,0,0,0,0,0,0,0,0,0,0,0,1,1,0,0,0,0,0,0,0,0,1
0,1,0,0,0,0,0,0,0,0,0,0,0,0,0,0,0,1,0,0,0,0,0,0,0,0,0,0,0,0,0,0,0,0,0,0,0,1,1,1,1,0,0,0,0,0,0,0,0,1
0,1,0,0,0,0,0,0,0,0,0,0,0,0,0,0,0,1,0,0,0,0,0,0,0,0,0,1,1,1,1,1,1,0,0,0,0,1,0,0,0,0,0,0,0,0,0,0,0,1
0,1,0,0,0,0,0,1,1,1,1,1,1,1,1,0,0,1,0,0,0,0,0,0,0,0,1,1,0,0,0,0,1,1,0,0,0,1,0,0,0,0,0,0,0,0,0,0,0,1
0,1,0,0,0,0,0,1,0,0,0,0,0,0,1,0,0,1,0,0,0,0,0,0,0,1,1,0,0,0,0,0,0,1,1,0,0,1,0,0,1,0,0,0,0,0,0,0,0,1
0,1,1,1,1,1,1,1,0,0,0,0,0,0,1,0,0,1,0,0,0,0,0,0,1,1,0,0,0,0,0,0,0,0,1,1,0,1,0,0,1,1,1,1,1,1,1,1,1,1
0,0,0,0,0,0,0,0,0,0,0,0,0,0,1,0,0,1,0,0,0,0,0,1,1,0,0,0,0,0,0,0,0,0,0,1,1,1,0,0,1,0,0,0,0,0,0,0,0,0
0,0,0,0,0,0,0,0,0,0,0,0,0,0,1,0,0,1,0,0,0,0,1,1,0,0,0,0,0,0,0,0,0,0,0,0,0,0,0,0,1,0,1,1,1,1,1,1,0,0
0,0,0,0,0,0,0,0,0,0,0,0,0,0,1,0,0,1,0,0,0,0,1,0,0,0,0,0,0,0,0,0,0,0,0,0,0,0,0,0,1,1,1,0,0,0,0,1,1,0
0,0,0,1,1,1,1,1,1,1,1,1,1,1,1,0,0,1,0,0,0,0,1,0,0,0,0,0,0,0,0,0,0,0,0,0,1,1,1,1,1,1,0,0,0,0,0,0,1,0
0,0,0,1,0,0,0,0,0,0,0,0,0,0,0,0,0,1,0,0,0,0,1,0,0,1,1,1,0,0,0,0,0,0,0,1,1,0,0,1,1,0,0,0,0,0,0,0,1,0
0,0,0,1,0,0,0,0,0,0,0,0,0,0,0,0,0,1,0,0,0,0,1,0,0,1,0,1,1,0,0,0,0,0,1,1,0,0,0,1,0,0,0,0,0,0,0,0,1,0
0,1,1,1,0,0,1,1,1,1,1,1,1,1,1,1,1,1,0,0,0,0,1,0,0,1,0,0,1,1,1,1,1,1,1,0,0,0,0,1,0,0,0,0,0,0,0,0,1,0
0,1,0,0,0,0,1,0,0,0,0,0,0,0,0,0,0,0,0,0,0,1,1,0,0,1,0,0,0,0,0,0,0,0,0,0,0,0,0,1,1,0,0,0,0,0,0,0,1,0
0,1,0,0,0,0,1,1,1,1,0,0,0,0,0,0,0,0,0,0,1,1,0,0,0,1,0,0,0,0,0,0,0,0,0,0,0,0,0,0,1,1,0,0,0,0,0,0,1,0
0,1,0,0,0,0,0,0,0,1,0,0,0,0,0,0,0,0,0,1,1,0,0,0,1,1,0,0,0,0,0,0,0,0,0,0,0,0,0,0,0,1,1,0,0,0,0,0,1,0
0,1,0,0,0,0,0,0,0,1,1,0,0,0,0,0,0,0,1,1,0,0,0,1,1,0,0,0,0,0,0,0,0,0,0,0,0,0,0,0,0,0,1,1,1,1,0,0,1,0
0,1,0,0,0,0,0,0,0,0,1,1,0,0,0,0,0,1,1,0,0,0,1,1,0,0,0,0,0,0,0,0,0,0,0,0,0,0,0,0,0,0,0,0,0,1,0,0,1,0
0,1,0,0,0,0,0,0,0,0,0,1,1,1,1,1,1,1,0,0,0,1,1,1,1,1,1,1,1,1,1,1,1,1,1,1,1,1,1,1,1,1,1,1,1,1,0,0,1,0
0,1,0,0,0,0,0,0,0,0,0,0,0,0,0,0,0,0,0,0,0,0,0,0,0,0,0,0,0,0,0,0,0,0,0,0,0,0,0,0,0,0,0,0,0,0,0,0,1,0
0,1,0,0,0,0,0,0,0,0,0,0,0,0,0,0,0,0,0,0,0,0,0,0,0,0,0,0,0,0,0,0,0,0,0,0,0,0,0,0,0,0,0,0,0,0,0,0,1,0
0,1,1,1,1,1,1,1,1,1,1,1,1,1,1,1,1,0,0,1,1,1,1,1,1,1,1,1,1,1,1,1,1,1,0,0,1,1,1,1,1,1,1,1,1,1,0,0,1,0
0,0,0,0,0,0,0,0,0,0,0,0,0,0,0,0,1,0,0,1,0,0,0,0,0,0,0,0,0,0,0,0,0,1,0,0,1,0,0,0,0,0,0,0,0,1,0,0,1,0
0,0,0,0,0,0,0,0,0,0,0,0,0,0,0,0,1,0,0,1,0,0,0,0,0,0,0,0,0,0,0,0,0,1,0,0,1,0,0,0,0,0,0,0,0,1,0,0,1,0
0,0,0,0,0,0,0,0,0,0,0,0,0,0,0,0,1,0,0,1,0,0,0,0,0,0,0,0,0,0,0,0,0,1,0,0,1,0,0,0,0,0,0,0,0,1,0,0,1,0
0,0,0,1,1,1,1,1,1,1,1,1,1,1,1,1,1,0,0,1,1,1,1,1,1,1,1,1,1,1,1,1,1,1,0,0,1,1,1,1,1,1,1,1,1,1,0,0,1,0
0,0,1,1,0,0,0,0,0,0,0,0,0,0,0,0,0,0,0,0,0,0,0,0,0,0,0,0,0,0,0,0,0,0,0,0,0,0,0,0,0,0,0,0,0,0,0,0,1,0
0,0,1,0,0,0,0,0,0,0,0,0,0,0,0,0,0,0,0,0,0,0,0,0,0,0,0,0,0,0,0,0,0,0,0,0,0,0,0,0,0,0,0,0,0,0,0,0,1,0
0,0,1,0,0,0,0,0,1,1,1,1,1,1,1,1,1,1,1,1,1,1,1,1,1,1,1,1,1,1,1,1,1,1,1,1,1,1,1,1,1,1,1,1,1,1,0,0,1,0
0,0,1,0,0,0,0,1,1,0,0,0,0,0,0,0,0,0,0,0,0,0,0,0,0,0,0,0,0,0,0,0,0,0,0,0,0,0,0,0,0,0,0,0,0,1,0,0,1,0
0,0,1,0,0,0,1,1,0,0,0,0,0,0,0,0,0,0,0,0,0,0,0,0,0,0,0,0,0,0,0,0,0,0,0,0,0,0,0,0,0,0,0,0,0,1,0,0,1,0
0,0,1,0,0,0,1,0,0,0,0,0,0,0,1,1,1,1,1,1,1,1,1,1,1,1,1,1,1,1,1,1,1,1,1,1,1,1,1,1,1,0,0,0,0,1,0,0,1,0
0,0,1,0,0,0,1,0,0,0,0,0,0,0,1,0,0,0,0,0,0,0,0,0,0,0,0,0,0,0,0,0,0,0,0,0,0,0,0,0,1,0,0,0,0,1,0,0,1,0
0,0,1,0,0,0,1,0,0,0,0,0,0,0,1,0,0,0,0,0,0,0,0,0,0,0,0,0,0,0,0,0,0,0,0,0,0,0,0,0,1,0,0,0,0,1,0,0,1,0
0,0,1,0,0,0,1,0,0,0,0,0,0,0,1,1,1,1,1,1,1,1,1,1,1,1,1,1,1,1,1,1,1,0,0,1,1,1,0,0,1,0,0,0,0,1,0,0,1,0
0,0,1,0,0,0,1,1,0,0,0,0,0,0,0,0,0,0,0,0,0,0,0,0,0,0,0,0,0,0,0,0,1,0,0,1,0,1,0,0,1,0,0,0,0,1,0,0,1,0
0,0,1,0,0,0,0,1,1,0,0,0,0,0,0,0,0,0,0,0,0,0,0,0,0,0,0,0,0,0,0,0,1,0,0,1,0,1,0,0,1,0,0,0,0,1,0,0,1,0
0,0,1,0,0,0,0,0,1,1,0,0,0,0,0,0,0,0,0,0,0,0,0,0,0,0,0,0,0,0,0,0,1,0,0,1,0,1,0,0,1,0,0,0,0,1,0,0,1,0
0,0,1,0,0,0,0,0,0,1,1,1,1,1,1,1,1,1,1,1,1,1,1,1,1,1,1,0,0,0,0,0,1,0,0,1,0,1,0,0,1,0,0,0,0,1,0,0,1,0
0,0,1,0,0,0,0,0,0,0,0,0,0,0,0,0,0,0,0,0,0,0,0,0,0,0,1,0,0,0,0,0,1,0,0,1,0,1,0,0,1,0,0,0,0,1,0,0,1,0
0,0,1,0,0,0,0,0,0,0,0,0,0,0,0,0,0,0,0,0,0,0,0,0,0,0,1,0,0,0,0,0,1,0,0,1,0,1,0,0,1,1,0,0,0,1,0,0,1,0
0,0,1,0,0,0,0,0,0,0,0,0,0,0,0,0,0,0,0,1,1,1,1,1,0,0,1,0,0,0,0,0,1,0,0,1,0,1,0,0,0,1,1,1,1,1,0,0,1,0
0,0,1,0,0,0,0,0,0,0,0,0,0,0,0,0,0,0,1,1,0,0,0,1,0,0,1,1,1,1,1,1,1,0,0,1,0,1,0,0,0,0,0,0,0,0,0,0,1,0
0,0,1,0,0,0,0,0,0,0,0,0,0,0,0,0,0,1,1,0,0,0,0,1,0,0,0,0,0,0,0,0,0,0,0,1,0,1,1,0,0,0,0,0,0,0,0,0,1,0
0,0,1,0,0,0,0,0,0,0,0,0,0,0,0,0,1,1,0,0,0,0,0,1,0,0,0,0,0,0,0,0,0,0,0,1,0,0,1,1,1,1,1,1,1,1,1,1,1,0
0,0,1,0,0,0,0,0,0,0,0,0,0,0,0,1,1,0,0,0,0,0,0,1,1,1,1,1,1,1,1,1,1,1,1,1,0,0,0,0,0,0,0,0,0,0,0,0,0,0
0,0,1,1,1,1,1,1,1,1,1,1,1,1,1,1,0,0,0,0,0,0,0,0,0,0,0,0,0,0,0,0,0,0,0,0,0,0,0,0,0,0,0,0,0,0,0,0,0,0

